board | bored
brake | break
berry | bury
chews | choose
coarse | course
crews | cruise
cue | queue
days | daze
dear | deer
desert | dessert
fair | fare
flour | flower
flew | flu
groan | grown
knows | nose
lessen | lesson
miner | minor
missed | mist
pain | pane
passed | past
peace | piece
principal | principle
profit | prophet
read | reed
read | red
role | roll
rose | rows
chute | shoot[y]/ʃuːt/-NAmE /ʃuːt/
sight | site[y]/saɪt/-NAmE /saɪt/
soar | sore[y]/sɔː(r)/-NAmE /sɔːr/
tail | tale[y]
threw | through[y]/θruː/-NAmE /θruː/
tide | tied[y]/taɪd/-NAmE /taɪd/
toe | tow[y]/təʊ/-NAmE /təʊ/
vain | vein[y]/veɪn/-NAmE /veɪn/
stationary | stationery[y]/ˈsteɪʃənri/-NAmE /ˈsteɪʃəneri/
dew | due[y]/djuː/-NAmE /duː/
grate | great[y]/ɡreɪt/ -NAmE /ɡreɪt/
lead | led[y]/led/-NAmE /led/
coward | cowered[y]/ˈkaʊəd/-NAmE /ˈkaʊərd/
idle | idol[y]/ˈaɪdl/-NAmE /ˈaɪdl/
rouse | rows[y]/raʊz/-NAmE /raʊz/
feat | feet[y]
muscle | mussel[y]/ˈmʌsl/-NAmE /ˈmʌsl/
navel | naval[y]/ˈneɪvl/-NAmE /ˈneɪvl/
vain | vein[y]/veɪn/-NAmE /veɪn/
desert | dessert[y]
pair | pare | pear[y]/peə(r)/-NAmE /per/
colonel | kernel[y]/ˈkɜːnl/-NAmE /ˈkɜːrnl/
cereal | serial[y]/ˈsɪəriəl/-NAmE /ˈsɪriəl/
foul | fowl[y]/faʊl/-NAmE /faʊl/
dear | deer[y]/dɪə(r)/-NAmE /dɪr/
councillor | counsellor[y]/ˈkaʊnsələ(r)/-NAmE /ˈkaʊnsələr/
council | counsel[y]/ˈkaʊnsl/-NAmE /ˈkaʊnsl/
belle | bell[y]/bel/-NAmE /bel/
premier | premiere[y]/ˈpremiə(r)/-NAmE /prɪˈmɪr/
née | neigh[y]/neɪ/-NAmE /neɪ/
complement | compliment[y]/ˈkɒmplɪmənt/-NAmE /ˈkɑːmplɪmənt/
knicker | nicker[y]/ˈnɪkə(r)/-NAme /ˈnɪkər/
groan | grown[y]/ɡrəʊn/-NAmE /ɡrəʊn/
cede | seed[y]/siːd/-NAmE /siːd/
guessed | guest[y]/ɡest/-NAmE /ɡest/
root | route[y]/ruːt/-NAmE /ruːt/
him | hymn[y]/hɪm/-NAmE /hɪm/
in | inn[y]/ɪn/-NAmE /ɪn/










[-] will || we'll
[-] whip || weep
[-] walking || working
[-] was || were || will 

germ || gem
fill || feel || field
their || they're || There
pen || pain || paint
copy || coffee
sleep || slip
drawn || drone
bet || bed
drain || rain
set || said
today || Tuesday || Thursday
today || Tuesday || Thursday
she'll || silk || sill
lithe || light
crew || group
degree || decrease
revile || prevail
tall || toll || told
code || cold || coat

game || gain 
merry || marry 
